


NO./maps/textures/n.xpm
F 10,20,230



C    0,200,255

                SO ./maps/textures/s.xpm
   WE     ./maps/textures/w.xpm
EA                                 ./maps/textures/e.xpm
        1111111111111111111111111
        1000000000110000010100001
        1001000001110000010100001
        1001000000000000000000001
111111111001000001110000000000001
100000000001000001110000111111111
11110111111111011100000000001
11110111111111011100011000001
11000000110101011100000000001
10000000000000000000000000111
1000000000000000110100000001111
1100000111000001111100N000011
11110111 1100001 101110000001
11111111 1111111 111111111111
